22 40
0 0 0 0 0 0 0 0 0 0 0 0 0 0 0 0 0 0 0 0 0 0 0 0 0 0 0 0 0 0 0 0 0 0 0 0 0 0 0 0 
0 1 1 1 1 1 1 5 1 1 4 1 3 5 1 1 1 1 1 3 1 3 1 1 1 1 1 1 1 5 1 1 1 1 3 1 1 1 1 0
0 1 3 5 3 1 1 1 1 1 1 5 1 1 1 1 1 1 1 1 1 3 4 1 1 3 1 1 1 1 5 1 1 1 1 1 5 1 1 0
0 1 1 1 1 1 1 1 1 1 1 5 1 1 5 1 1 1 1 1 3 1 3 1 1 3 1 1 1 1 1 1 1 1 3 1 1 1 1 0
0 3 1 5 5 1 1 1 1 1 1 1 1 1 3 1 1 1 1 1 1 3 1 1 3 1 1 1 1 3 1 1 1 3 1 1 1 1 1 0
0 3 1 3 3 1 1 1 1 1 1 1 1 1 3 3 1 1 3 1 1 1 1 1 1 1 1 3 1 1 1 1 1 1 3 1 3 5 1 0
0 1 1 1 3 1 1 3 1 1 1 1 1 1 1 1 3 1 1 1 1 1 3 1 5 3 1 1 1 1 1 1 1 1 3 1 3 3 1 0
0 2 2 2 2 2 2 2 2 2 2 2 2 2 2 2 2 2 2 2 2 2 2 2 2 2 2 2 2 2 2 1 1 1 3 1 1 3 1 0
0 1 5 1 1 1 3 1 1 4 1 5 1 1 3 1 3 1 1 1 1 1 1 1 1 1 1 4 1 3 5 1 1 1 1 1 1 3 1 0
0 1 1 4 1 1 1 1 1 3 1 1 1 1 1 5 1 1 1 1 1 1 1 1 3 5 5 3 1 1 4 1 1 1 1 3 1 1 1 0
0 1 1 1 3 1 1 3 1 3 1 1 1 1 1 1 1 1 1 1 1 1 1 1 3 3 1 3 1 1 3 1 1 1 1 1 1 1 1 0
0 1 5 1 1 1 1 1 3 1 1 1 1 1 1 1 1 3 3 5 1 1 1 1 1 1 1 3 1 1 3 1 4 1 1 1 1 5 1 0
0 1 3 1 1 5 1 1 3 1 5 5 1 1 1 1 1 3 1 3 4 1 1 4 1 1 1 1 3 1 1 1 3 1 1 4 1 1 1 0
0 1 4 3 1 1 1 1 1 1 1 1 1 1 1 1 1 1 3 3 3 1 1 3 1 1 1 1 1 1 1 1 4 1 1 1 1 1 3 0
0 1 1 1 1 1 1 1 1 2 2 2 2 2 2 2 2 2 2 2 2 2 2 2 2 2 2 2 2 2 2 2 2 2 2 2 2 2 2 0
0 5 5 1 1 1 1 1 1 1 1 1 5 1 1 1 4 1 1 1 1 3 1 1 1 1 1 3 1 1 1 3 1 1 1 1 1 1 1 0
0 3 5 1 1 1 1 1 1 1 1 1 3 3 1 1 3 1 1 1 1 1 1 1 1 3 1 1 1 1 1 1 3 1 3 5 1 1 0 0
0 1 3 1 1 3 1 1 1 1 1 1 1 1 3 1 1 1 1 1 3 1 5 5 1 1 1 1 4 1 1 1 3 1 3 3 1 1 1 0
0 1 1 1 1 3 4 1 1 5 1 1 1 1 1 1 1 3 1 1 1 1 1 1 1 3 1 3 4 1 1 1 1 1 1 3 1 1 1 0
0 1 1 1 5 1 1 5 1 3 1 1 3 1 3 3 1 1 1 1 1 1 1 1 1 3 1 3 4 1 1 1 1 1 1 3 1 1 3 0
0 1 4 1 1 1 1 3 1 1 1 1 1 5 1 1 1 1 1 1 1 1 1 5 1 3 1 1 3 1 1 1 1 3 1 1 1 3 1 0
0 0 0 0 0 0 0 0 0 0 0 0 0 0 0 0 0 0 0 0 0 0 0 0 0 0 0 0 0 0 0 0 0 0 0 0 0 0 0 0
